Aron: gabuu_ggajheadafhdeajicdj
Asia: gab_ddeeebdcjegdjfbiddh
Ate Feni: gabuu_cbgbhfefefjfiecieig
Austin: gabuu_cebcbbgfjegecefcjd
CJ Max: gabuu_ffadfhibajgihjhbjii
CJ: gabuu_dadgeeaifdghhgchdce
Drei: gabuu_edfijdiaegefjbhfbjb
Earl: gab_dejiccejbiifbejeggb
Eyroncakes: gabuu_badaajiijhabicgffhf
Frongs: gabuu_iicgbdgdahjjdjfhggf
Gab: gab_ecgebiaajfhejajegfj
Ge: gabuu_cigceghgejccbddjiaj
Jamie: gabuu_igjedfgchddieegidba
Jax: gabuu_cjccgibcihacjichiie
Job: gabuu_hjdaaeccedjgafcdabd
Joecile: gab_ghchieajdgbjcfbehdj
Jos Eph: gab_ebfjhjidciaaffjjedc
Julia: gabuu_hjfcjahbdabbjdjbbba
Kaye: gabuu_dgbfijadbfhdgbjjbig
Keyrex: gab_facigecbahgeggceigd
KJ: gab_gcgjjdcbdhhiichggff
Kuya Lester: gab_cicbhbaedijefgdeddi
Lars: gab_gbjgahdbaidhgchfafe
Marco: gabuu_faejhjhfibgehgjjigi
Marielle: gabuu_ehchfhjfejjfeigdfdf
Marvel: gabuu_gfddcjjdhbehhfjhha
Mayen: gab_jaihaiigcfhhbgjbdea
Mike Aaron: gabuu_iahhfcbghceigdacjhb
Mokoshark: gabuu_gcehhiedifciafehaf
Nico: gabuu_cfacbdeedbihiijbdbi
Raj: gab_ibjiaificeghhaadbji
Sir Dave: gab_bfchgejdhjaicdjghif
Sir Dom: gab_ddfhihfajgdhhdgjihe
Sir Lari: gabuu_cbagjdibgaeiebiacaa
Sir Levi: gabuu_ceddchcidibgdeacbej
Toby: gabuu_ghfeefciaifajbfebh
Tyrone: gabuu_dcihiajcdegfbdbegja
Yang: gab_edajgffjeffeigehhei
